{
  "Level": {
    "Level": 3,
    "Duration_In_Seconds": 60,
    "Object_Pulse": 2,
    "Object_Speed": 15
  },

  "Patterns": [
    [0, 0, 0, 1, 1, 1, 1, 1],
    [0, 0, 1, 0, 1, 1, 1, 1],
    [0, 1, 0, 0, 1, 1, 1, 1],
    [1, 0, 0, 1, 1, 1, 1, 1],
    [1, 0, 0, 1, 1, 1, 1, 1],
    [0, 1, 1, 0, 1, 1, 1, 1]
  ]
}
